Articana
An Interactive Fiction by Articana Troupe
Release 1 / Serial number 200216 / Inform 7 build 6M62 (I6/v6.33 lib 6/12N) SD

Lobby
Entering the church, you are greeted by a nice enough looking lobby.  You see open and tabled areas where church visitors would converse, as well as desks for church relations and small curtained alcoves for confessionals. Nobody seems to be around.

There are several archways along the south wall, through which you can see the main church hall.

You can see Help Desk here.

>look help desk
You see nothing special about Help Desk.

>look
Lobby
Enterring the chruch, you are greeted by a nice enough looking lobby.  You see open and tabled areas where church visitors would converse, as well as desks for church relations and smal curtainedl alcoves for confessionals.

You can see Help Desk here.

>look confessionals
You see nothing special about Confessional.

>go n
You can't go that way.

>n
You can't go that way.

>s
Nave
Here in the nave, they clearly have the AC runnig full time, as the room is quite colde.  The seating here lines up vertically in 3 distinct sections.  One is on the ground floor you have just walked out in, with the other sections aligned above and below you.  They all surround an icy pillar farther in, a spiral ramp reaching around it.  Behind the pillar, a curved wall blocks view, but a small door near the base leads behind it.

You can see Pillar here.

* * *

>look help desk
You see nothing special about Help Desk.

>s
Nave
Here in the nave, the installed heating units seem to be malfunctioning, as the room is quite cold.  Your footsteps echo off of the vaulted ceiling above you.

The room is slanted towards the middle, fog gently cascading along the floor towards it. The carved stone pews here are clustered into 3  tiers, one on ground level and one each on the upper and lower tier.They all surround an icy pillar farther in, a spiral ramp reaching around it and the rolling fog lingering around the base.  Behind the pillar along the south wall, a curved wall blocks your view, but a small door near the base appears to lead behind it.

You can feel the relative heat of the lobby and see some of the tables through the archways to the north.

The pillar seems to pulse as the fog collects around the base. Staring at it long enough, you almost think you can see shapes moving inside the ice...

>s
Backstage
As you enter this small room, you see materials that might be immediately useful to give a sermon scattered about.  There are religious documents, some extra religious symbols, a small machine that gives off an icy fog, as well as some blocks of ice that you remember would be handed out to audience members.  A spiral staircase leading both up and down is in the back of the room.

Just a bunch of loose papers, Scanning through them, nothing seems to be out of the ordinary for a sermon of the church of Icidious.

You see a smooth slate pendant with a carved impression of an Ice Core on it. Symbols of Icidious" followers.

It seems that the thematic fog isn't entirely natural... but most religious services here could add a flair of drama.

These look like ice cubes that are given out to believers during sermons. Despite the ambient temperature, they seem not to melt.

* * *

Articana
An Interactive Fiction by Articana Troupe
Release 1 / Serial number 200216 / Inform 7 build 6M62 (I6/v6.33 lib 6/12N) SD

Lobby
Entering the church, you are greeted by a nice enough looking lobby.  You see open and tabled areas where church visitors would converse, as well as desks for church relations and small curtained alcoves for confessionals. Nobody seems to be around.

There are several archways along the south wall, through which you can see the main church hall.

You can see Help Desk here.

>s
Nave
Here in the nave, the installed heating units seem to be malfunctioning, as the room is quite cold.  Your footsteps echo off of the vaulted ceiling above you.

The room is slanted towards the middle, fog gently cascading along the floor towards it. The carved stone pews here are clustered into 3  tiers, one on ground level and one each on the upper and lower tier.They all surround an icy pillar farther in, a spiral ramp reaching around it and the rolling fog lingering around the base.  Behind the pillar along the south wall, a curved wall blocks your view, but a small door near the base appears to lead behind it.

You can feel the relative heat of the lobby and see some of the tables through the archways to the north.

The pillar seems to pulse as the fog collects around the base. Staring at it long enough, you almost think you can see shapes moving inside the ice...

>s
Backstage
As you enter this small room, you see materials that might be immediately useful to give a sermon scattered about.

A spiral staircase leading both up and down is in the back of the room.

You can see a Religious Documents, a Religious Symbols, a Fog Machine and an Ice Blocks here.

>look religious documents[tab]
Just a bunch of loose papers, Scanning through them, nothing seems to be out of the ordinary for a sermon of the church of Icidious.

>n
Nave
Here in the nave, the installed heating units seem to be malfunctioning, as the room is quite cold.  Your footsteps echo off of the vaulted ceiling above you.

The room is slanted towards the middle, fog gently cascading along the floor towards it. The carved stone pews here are clustered into 3  tiers, one on ground level and one each on the upper and lower tier.They all surround an icy pillar farther in, a spiral ramp reaching around it and the rolling fog lingering around the base.  Behind the pillar along the south wall, a curved wall blocks your view, but a small door near the base appears to lead behind it.

You can feel the relative heat of the lobby and see some of the tables through the archways to the north.

The pillar seems to pulse as the fog collects around the base. Staring at it long enough, you almost think you can see shapes moving inside the ice...

>s
Backstage
As you enter this small room, you see materials that might be immediately useful to give a sermon scattered about.  There are religious documents, some extra religious symbols, a small machine that gives off an icy fog, as well as some blocks of ice that you remember would be handed out to audience members.  A spiral staircase leading both up and down is in the back of the room.

You can see a Religious Documents, a Religious Symbols, a Fog Machine and an Ice Blocks here.

>up
Office
*IF YOU DONT HAVE A KEY PLS TURN AROUND* This lower area sits below the main floor.  Looking up, the ceiling is clear, giving you another look at the eye imagery of the temple itself.  You've entered an office, containing documents, file cabinets, computers, and a large desk with chairs.  Rummaging around, you notice that in the financial records, the churhc has given a decent amount of money to the group KAOS.  You can clearly see the two are linked now, but why is your new question.

You can see a Private Office Door here.

>e
(first opening the Private Office Door)

Private Office
This room is split into two sections.  One appears ike a nice bedroom, the other a well furnished private office.  Documents and books are stacked neatly on the desk in the office.  Rummaging through them, you come across a journal of some kind.  Reading through, you find the evidence you've been looking for.  Acoording to this head priest, the church is using its position to support KAOS by spreading an advocating for CSM, causing more hallucinations.  He makes note that this is the will of Icidious, and  if humanity will abuse the essence of his god, then they will suffer the consequences.  This is what you've been looking for, time to get out of here.

You can see a Private Office Door and a Journal here.

>lock
What do you want to lock?

>lock door
The deadbolt clicks into place as you lock the door.

>w
Office
*IF YOU DONT HAVE A KEY PLS TURN AROUND* This lower area sits below the main floor.  Looking up, the ceiling is clear, giving you another look at the eye imagery of the temple itself.  You've entered an office, containing documents, file cabinets, computers, and a large desk with chairs.  Rummaging around, you notice that in the financial records, the churhc has given a decent amount of money to the group KAOS.  You can clearly see the two are linked now, but why is your new question.

You can see a Private Office Door here.

>e
Private Office
This room is split into two sections.  One appears ike a nice bedroom, the other a well furnished private office.  Documents and books are stacked neatly on the desk in the office.  Rummaging through them, you come across a journal of some kind.  Reading through, you find the evidence you've been looking for.  Acoording to this head priest, the church is using its position to support KAOS by spreading an advocating for CSM, causing more hallucinations.  He makes note that this is the will of Icidious, and  if humanity will abuse the essence of his god, then they will suffer the consequences.  This is what you've been looking for, time to get out of here.

You can see a Private Office Door and a Journal here.

>lock private office door
The Private Office Door is already locked.

>e
You can't go that way.

>w
Office
*IF YOU DONT HAVE A KEY PLS TURN AROUND* This lower area sits below the main floor.  Looking up, the ceiling is clear, giving you another look at the eye imagery of the temple itself.  You've entered an office, containing documents, file cabinets, computers, and a large desk with chairs.  Rummaging around, you notice that in the financial records, the churhc has given a decent amount of money to the group KAOS.  You can clearly see the two are linked now, but why is your new question.

You can see a Private Office Door here.

>w
You can't go that way.

>w
You can't go that way.

>e
Private Office
This room is split into two sections.  One appears ike a nice bedroom, the other a well furnished private office.  Documents and books are stacked neatly on the desk in the office.  Rummaging through them, you come across a journal of some kind.  Reading through, you find the evidence you've been looking for.  Acoording to this head priest, the church is using its position to support KAOS by spreading an advocating for CSM, causing more hallucinations.  He makes note that this is the will of Icidious, and  if humanity will abuse the essence of his god, then they will suffer the consequences.  This is what you've been looking for, time to get out of here.

You can see a Private Office Door and a Journal here.

>e
You can't go that way.

* * *

>s
Backstage
As you enter this small room, you see materials that might be immediately useful to give a sermon scattered about.

A spiral staircase leading both up and down is in the back of the room.

You can see a Religious Documents, a Religious Symbols, a Fog Machine and an Ice Blocks here.

>u
Office
This lower area sits below the main floor.  Looking up, the ceiling is clear, giving you another look at the eye imagery of the temple itself.  You've entered an office, containing documents, file cabinets, computers, and a large desk with chairs. TIme to search the office.

You can see a Private Office Door here.

>e
(first opening the Private Office Door)
It seems to be locked.

>e
(first opening the Private Office Door)
It seems to be locked.

>unlock private office door
You can't unlock the door from this side without the key.

>w
You can't go that way.

>s
You can't go that way.

>d
Backstage
As you enter this small room, you see materials that might be immediately useful to give a sermon scattered about.  There are religious documents, some extra religious symbols, a small machine that gives off an icy fog, as well as some blocks of ice that you remember would be handed out to audience members.  A spiral staircase leading both up and down is in the back of the room.

You can see a Religious Documents, a Religious Symbols, a Fog Machine and an Ice Blocks here.

>d
Old Library
This area extends back over the nave.  The floor is clear here, as if a one way window.  Looking down, you see the floors below resemble an eye.  You can't tell if the sudden chill is from the cold or from the feeling of being watched.  This room is lined with shelves containing different books and manuscripts.  Many of them are copies of each other, but each is some piece of religious text or propoganda about Icidious, the ice god.

>e
You can't go that way.

>s
You can't go that way.

>n
Storage Room
The floor here is still clear.  The room here is a storage room, containing old stage props, surplus religious wear, and more.  A key sits on a small desk in the corner of the room.  More interestingly, one box contains vials of a light blue liquid you know to be CSM.  To your knowledge, CSM is the root cause of the hallcucinations plaguing the nation.  It is interesting the church has so much of it, but it isn't directly incriminating of anything.  You must keep searching..

You can see an Office Key and a CSM here.

>take key
Taken.

>s
Old Library
This area extends back over the nave.  The floor is clear here, as if a one way window.  Looking down, you see the floors below resemble an eye.  You can't tell if the sudden chill is from the cold or from the feeling of being watched.  This room is lined with shelves containing different books and manuscripts.  Many of them are copies of each other, but each is some piece of religious text or propoganda about Icidious, the ice god.

>u
Backstage
As you enter this small room, you see materials that might be immediately useful to give a sermon scattered about.  There are religious documents, some extra religious symbols, a small machine that gives off an icy fog, as well as some blocks of ice that you remember would be handed out to audience members.  A spiral staircase leading both up and down is in the back of the room.

You can see a Religious Documents, a Religious Symbols, a Fog Machine and an Ice Blocks here.

>u
Office
*IF YOU DONT HAVE A KEY PLS TURN AROUND* This lower area sits below the main floor.  Looking up, the ceiling is clear, giving you another look at the eye imagery of the temple itself.  You've entered an office, containing documents, file cabinets, computers, and a large desk with chairs.  Rummaging around, you notice that in the financial records, the churhc has given a decent amount of money to the group KAOS.  You can clearly see the two are linked now, but why is your new question.

You can see a Private Office Door here.

>unlock door
You unlock the Private Office Door.

>w
You can't go that way.

>e
(first opening the Private Office Door)

Private Office
This room is split into two sections.  One appears ike a nice bedroom, the other a well furnished private office.  Documents and books are stacked neatly on the desk in the office.  Rummaging through them, you come across a journal of some kind.  Reading through, you find the evidence you've been looking for.  Acoording to this head priest, the church is using its position to support KAOS by spreading an advocating for CSM, causing more hallucinations.  He makes note that this is the will of Icidious, and  if humanity will abuse the essence of his god, then they will suffer the consequences.  This is what you've been looking for, time to get out of here.

You can see a Private Office Door and a Journal here.

>lock door
The deadbolt clicks into place as you lock the door.

* * *

>u
Office
This lower area sits below the main floor.  Looking up, the ceiling is clear, giving you another look at the eye imagery of the temple itself.  You've entered an office, containing documents, file cabinets, computers, and a large desk with chairs. TIme to search the office.

You can see a Private Office Door here.

>search
(the Private Office Door)
 Spending several minutes rummaging around, you notice that in the financial records on the computer and in the cabinets, the church has given a decent amount of money to the group KAOS.  You can clearly see the two are linked now, but the new question is... why?

>search office
Spending several minutes rummaging around, you notice that in the financial records on the computer and in the cabinets, the church has given a decent amount of money to the group KAOS.  You can clearly see the two are linked now, but the new question is... why?

>w
You can't go that way.

>go through door
(first opening the Private Office Door)
It seems to be locked.

I beg your pardon?

>d
Backstage
As you enter this small room, you see materials that might be immediately useful to give a sermon scattered about.

A spiral staircase leading both up and down is in the back of the room.

You can see a Religious Documents, a Religious Symbols, a Fog Machine and an Ice Blocks here.

>d
Old Library
This area extends back over the nave.  The floor is clear here, as if a one way window.  Looking down, you see the floors below resemble an eye.  You can't tell if the sudden chill rolling up your spine is from the cold or from the feeling of being watched.  This room is lined with shelves containing different books and manuscripts.  Many of them are copies of each other, but each is some piece of religious text or propoganda about Icidious, the ice god.

>w
You can't go that way.

>e
You can't go that way.

* * *

>s
You can't go that way.

>n
Storage Room
The floor here is still clear.  The room here is a storage room, containing old stage props, surplus religious wear, and more.  A key sits on a small desk in the corner of the room.  A box in the corner labeled FRAGILE looks to have been moved recently.

You can see an Office Key and a Fragile Box here.

>look box
More interestingly, this box contains vials of a light blue liquid you know to be CSM.  From your previous research, you know that CSM is the root cause of the hallucinations plaguing the nation.  It is interesting the church has so much of it, but it is something that could easily be explained away.  You must keep searching..

* * *

>s
Backstage
As you enter this small room, you see materials that might be immediately useful to give a sermon scattered about.

A spiral staircase leading both up and down is in the back of the room.

You can see a Religious Documents, a Religious Symbols, a Fog Machine and an Ice Blocks here.

>d
Old Library
This area extends back over the nave.  The floor is clear here, as if a one way window.  Looking down, you see the floors below resemble an eye.  You can't tell if the sudden chill rolling up your spine is from the cold or from the feeling of being watched.  This room is lined with shelves containing different books and manuscripts.  Many of them are copies of each other, but each is some piece of religious text or propoganda about Icidious, the ice god.

>s
You can't go that way.

>e
You can't go that way.

>n
Storage Room
The floor here is still clear.  The room here is a storage room, containing old stage props, surplus religious wear, and more.  A key sits on a small desk in the corner of the room.  A box in the corner labeled FRAGILE looks to have been moved recently.

You can see an Office Key and a FRAGILE Box here.

>take key
Taken.

>s
Old Library
This area extends back over the nave.  The floor is clear here, as if a one way window.  Looking down, you see the floors below resemble an eye.  You can't tell if the sudden chill rolling up your spine is from the cold or from the feeling of being watched.  This room is lined with shelves containing different books and manuscripts.  Many of them are copies of each other, but each is some piece of religious text or propoganda about Icidious, the ice god.

>u
Backstage
As you enter this small room, you see materials that might be immediately useful to give a sermon scattered about.

A spiral staircase leading both up and down is in the back of the room.

You can see a Religious Documents, a Religious Symbols, a Fog Machine and an Ice Blocks here.

>u
Office
This lower area sits below the main floor.  Looking up, the ceiling is clear, giving you another look at the eye imagery of the temple itself.  You've entered an office, containing documents, file cabinets, computers, and a large desk with chairs. The office would be a smart place to search.

There is a dark door to the north, and a door to the east labeled "PRIVATE - FOR THE HEAD PRIEST ONLY".

You can see a Private Office Door here.

>unlock door
You unlock the Private Office Door.

>go through door
(first opening the Private Office Door)

Private Office
You enter a well-furnished private office.  Documents and books are stacked neatly on the desk in the office. Considering the room's previously locked state, you have a good feeling about searching this room.

You can see a bedroom through the open door to the south.

You can see a Private Office Door here.

>search office
(the Office Key)
Rummaging through the desk, you come across a journal of some kind.  Reading through it, you find the evidence you've been looking for.  According to this head priest, the church is using its position to support KAOS by advocating the use of CSM and distributing it to its parishioners, causing more hallucinations.  He makes note that this is the will of Icidious, and if humanity will abuse the essence of his god, then they must suffer the consequences.

This is what you've been looking for! Time to get out of here before anyone returns!

Taken.

>i
You are carrying:
  a Journal
  an Office Key

* * *

Articana
An Interactive Fiction by Articana Troupe
Release 1 / Serial number 200216 / Inform 7 build 6M62 (I6/v6.33 lib 6/12N) SD

Lobby
Entering the church, you are greeted by a nice enough looking lobby.  You see open and tabled areas where church visitors would converse, as well as desks for church relations and small curtained alcoves for confessionals. Nobody seems to be around.

There are several archways along the south wall, through which you can see the main church hall.

You can see Help Desk here.

>look help
Nobody is sitting here. You ding the bell, and noone comes.

>s
Nave
Here in the nave, the installed heating units seem to be malfunctioning, as the room is quite cold.  Your footsteps echo off of the vaulted ceiling above you.

The room is slanted towards the middle, fog gently cascading along the floor towards it. The carved stone pews here are clustered into 3  tiers, one on ground level and one each on the upper and lower tier.They all surround an icy pillar farther in, a spiral ramp reaching around it and the rolling fog lingering around the base.  Behind the pillar along the south wall, a curved wall blocks your view, but a small door near the base appears to lead behind it.

You can feel the relative heat of the lobby and see some of the tables through the archways to the north.

The pillar seems to pulse as the fog collects around the base. Staring at it long enough, you almost think you can see shapes moving inside the ice...

* * *

>u
Office
This lower area sits below the main floor.  Looking up, the ceiling is clear, giving you another look at the eye imagery of the temple itself.  You've entered an office, containing documents, file cabinets, computers, and a large desk with chairs. TIme to search the office.

You can see a Private Office Door here.

>search
(the Private Office Door)
You find nothing of interest.

>search office
You find nothing of interest.

>search
(the Private Office Door)
You find nothing of interest.